92  10
0  0  0  0  0  0  0  0  0  0  0  0  0  0  0  0  0  0  0  0  0  0  0  0  0  0  0  0  0  0  0  0  0  0  0  0  0  0  0  0  0  0  0  0  0  0  0  0  0  0  0  0  0  0  0  0  0  0  0  0  0  0  0  0  0  0  0  0  0  0  0  0  0  0  0  0  0  0  0  0  0  0  0  0  0  0  0  0  0  0  0  0
0  0  0  0  0  0  0  0  0  0  0  0  0  0  0  0  0  0  0  0  0  0  0  0  0  0  0  0  0  0  0  0  0  0  0  0  0  0  0  0  0  0  0  0  0  0  0  0  0  0  0  0  0  0  0  0  0  0  0  0  0  0  0  0  0  0  0  0  0  0  0  0  0  0  0  0  0  0  0  0  0  0  0  0  0  0  0  0  0  0  0  0
0  0  0  0  0  0  0  0  0  0  0  0  0  0  0  0  0  0  0  0  0  0  0  0  0  0  0  0  0  0  0  0  0  0  0  0  0  0  0  0  0  0  0  0  0  0  0  0  0  0  0  0  0  0  0  0  0  0  0  0  0  0  0  0  0  0  0  0  0  0  0  0  0  0  0  0  0  0  0  0  0  0  0  0  0  0  0  0  0  0  0  0
0  0  0  0  0  0  0  0  0  0  0  0  0  0  0  0  0  0  0  0  0  0  0  0  0  0  0  0  0  0  0  0  0  0  0  0  0  0 -2 -2 -2  0  0  0  0  0  0  0  0  0  0  0  0  0  0  0  0  0  0  0  0  0  0  0  0  0  0  0  0  0  0  0  0  0  0  0  0  0  0  0  0  0 -1  0  0  0  0  0  0  0  0  0
0  0  0  0  0  0  0  0  0 -1  0  0  0  0  0  0  0  0  0  0  0  0  0  0  0  0  0  0  0  0  0  0 -1  0  0  0  0  0 -2 -2 -2  0  0  0  0  6  0  0  0  0  0  0  0  0  0 -1  0  0  0  0  0  0  0  0  0  0  0 -2 -2 -2  0  0  0  0  0  0  0  0 -1  0  0  0  0  0  0  0  0  0  0  0  0  6
0  0  0  0  0 -2 -2  0  0  0  0  0  0  0  0  0  0  0  0  0  0 -2 -2 -2  0  0  0  0 -2 -2  0  0  0  0  0  0  6  6  0  0  0  0  0  0  0  0  0  0  0  0 -2 -2  0  0  0  0  0  0  0  0  0  0  0  0  0 -2 -2 -2  0  0  0  0  0 -2 -2  0  0  0  0  0  0  0  0  0 -3  0  0  0  0  0 -4  2
0  0  0  0  0  0  0  0  0  0  0  0  0  0  0  0  0  0  0  0  0 -2 -2 -2  0  0  0  0 -2 -2  0  0  0  0  6  6  6  0  0  0  0  0  0  0  0  0  0  0  0  0  0  0  0  0  0  0  0  0  0  0  0  0  0  0  0  0  0 -2 -2 -2  0  0  0  0 -2 -2  0  0  0  0  8  8  8  8  8  0  0  0  0  0  6  2
0  0  0  0  0  0  0  0  0  0  0  0  0  0  0 -1  0  0  0  0  0  6  6  6  0  0 -1  0  0  0  0  0  6  6  6  0  0  0  0  0  0  0  6  6  6  0  0  0  0  0  0  0  0  0  0  0  0  0  0  0  0 -1  0  0  0  0  0  6  6  6  0  0  0  0  0  0  0  0  8  8  0  0  0  0  0  0  0  0  6  6  2  2
6  0 -1  0  0  5  6  6  6  0  0  0  0  0  0  0  0  0  0  0  0  0  0  0  0  0  0  0  6  6  6  6  0  0  0  0  0  0  0  0  0  6  2  2  2  2  6  0 -1  0  0  6  6  6  6  0  0  0  0  0  0  0  0  0  0  0  0  0  0  0  0  0 -1  0  6  6  6  6  0  0  0  0  0  0  0  0  0  6  2  2  2  2
2  6  6  6  6  2  2  2  2  6  6  6  6  6  6  6  6  6  6  6  6  6  6  6  6  6  6  6  2  2  2  2  6  6  6  6  6  6  6  6  6  6  2  2  2  2  2  6  6  6  6  2  2  2  2  6  6  6  6  6  6  6  6  6  6  6  6  6  6  6  6  6  6  6  2  2  2  2  6  6  6  6  6  6  6  6  6  2  2  2  2  2
