46  10
0  0  0  0  0  0  0  0  0  0  0  0  0  0  0  0  0  0  0  0  0  0  0  0  0  0  0  0  0  0  0  0  0  0  0  0  0  0  0  0  0  0  0  0  0  0
0  0  0  0  0  0  0  0  0  0  0  0  0  0  0  0  0  0  0  0  0  0  0  0  0  0  0  0  0  0  0  0  0  0  0  0  0  0  0  0  0  0  0  0  0  0
0  0  2  2  0  0  0  0  0  0  0  0  0  0  0  0  0  0  0  0  0  0  0  0  0  0  0  0  0  0  0  0  0  0  0  0  0  0  0  0  0  0  0  0  0  0
0  0  0  0  0  0  0  0  0 -1  0  0  0  0  0  0  0  0  0  0  0 -2 -2 -3  0  0  0  0  0  0  0  0 -1  0  0  0  0  0  0  0  0  0  1  2  2  8
0  0  0  0  0  0 -2  2  0  0  0  0  0  0  0  0  0  0  0  0  0 -2 -2  2  0  0  0  0 -2 -2  0  0  0  0  0  0  0  0  0  0  0  0  8  0  0  8
1  0  0  0  0  0  0  0  0  0  0  0  0  0  0  0  0  0  0  0  0 -2 -2 -2  0  0  0  0 -2 -2  0  0  0  0  0  0  0  0  0  0  0  0  0  0  0  8
1  1  0  0  0  0  0 -2  0  0  0  0  0  0  0  0  0  0  0  0  1  1  1  1  0  0  0  0  0  0  0  0  0  0  0  0  0  0  0  0  0  0  0  0  0  8
1  1  0  0 -1  0  6  6  6  0  0  0  0  2  2  0  0  0  1  1  1  1  1  1  0  0 -1  0  6  6  6  6  0  0  0  0  0  0  0  1  0  0  0  0 -4  8
1  1  1  1  1  1  1  1  1  1  5  5  5  1  1  1  1  1  1  1  1  1  1  1  1  1  1  1  1  1  1  1  1  1  3  3  3  1  1  1  0  0  1  1  1  8
1  1  1  1  1  1  1  1  1  1  1  1  1  1  1  1  1  1  1  1  1  1  1  1  1  1  1  1  1  1  1  1  1  1  1  1  1  1  1  1  0  0  1  1  1  1
