46  10
0  0  0  0  0  0  0  0  0  0  0  0  0  0  0  0  0  0  0  0  0  0  0  0  0  0  0  0  0  0  0  0  0  0  0  0  0  0  0  0  0  0  0  0  0  0
0  0  0  0  0  0  0  0 -3  0  0  0  0  0  0  0  0  0  0  0  0  0  0  0  0  0  0  0  0  0  0  0  0  0  0  0  0  0  0  0  0  0  0  0  0  0
0  0  0  2  2  0  0  2  2  2  0  0  0  0  0  0  0  0  0  0  0  0  0  0  0  0  0  0  0  0  0  0  0  0  0  0  0  0  0  0  0  0  0  0  0  0
0  0  0  0  0  0  0  0  0  0  0  0  0  0  0  0  0  0  0  0  0  0  0  0  0  0  0  0  0  0  0  0  0  0  0  0  0  0  0  0  0  0  0  0  0  0
1  0  2  2  2  2  2  0  0  0  0  0  0  0  0  0  0  0  0  0  0  0  0  0  0  0  0  0  0  0  0  0 -1  0  0  0  0  0  0  0  0  0  0  0  0  8
1  0  0  0  0 -2 -2  0  0  0  0  0  0  0  0  0  0  0  0  0  0  0  0  0  0  0  0  0 -2 -2  0  0  0  0  0  0  0  0  8  8  0  0  0  0  0  8
1  1  0  0  0  0  2  2  0  0  0  0  0  0  0  0  0  0  0 -1  0  0  0  0  0  0  0  0 -2 -2  0  0  0  0  0  0  0  0  0  0  0  0  0  0 -4  8
1  1  0  0  0  0  0 -1  3  0  0  0  0  0  0  0  1  0  0  0  0  1  0  0  0  0  0  0  0  1  1  0  0  0  5  5  5  0  0  0  0  0  0  1  1  8
1  1  0  0  6  6  6  6  6  0  0  0  6  6  0  0  1  1  1  1  1  1  3  0  0  0 -1  0  6  6  6  0  0  0  1  1  1  0  0  0  0  0  1  1  1  8
1  1  1  1  1  1  1  1  1  1  1  0  1  1  1  1  1  1  1  1  1  1  1  1  1  1  1  1  1  1  1  1  1  1  1  1  1  1  1  1  6  1  1  1  1  8

